PBBBBO..BOHBH.H
.HBHBTB..TBB.P.
...BBO.BBOHBHBH
BHBHBTB..TBBBBB
BBBBBO..BOHBHBH
BHBHBTBB..BBBBB
TOTOTO..BOTOTOT
BBBBB.B..TBHBHB
HBHBHO.BBOBBBBB
BBBBBTB..TBHBHB
H.HBHO..BOBBBB.
.PBBBTBB.TBHBH.
H.HBHO..BOBBB.P